18
XXXXXXXXXXXXXXXXXXXXXXXX
XXGG04GGGGGGGGGGGGGGGGXX
XXGGPPGGXXXXXXXXXXXXXXXX
XXGGGGGGGG02GGGGGGGGGGXX
XXGGGG02XXXXXXGGGGGGGGXX
XXGGGGGGWWWWXXXXGGGGGGXX
XXGGGGWWWWWWWWXXGG05GGXX
XX05GGGGWWWWXXGGGGHHGGXX
XXGGGGGGGGGGXXIIIIIIIIXX
XXGGGGGGGGGGGGGGGGDDDDXX
XXGG05GGGGGGGGGGDDDDDDXX
XXXXXXXXXXXXXXXXXXXXXXXX
