26
XXXXXXXXXXXXXXXXXXXXXXXX
XXGGGGGGGGGGHIGGGGGGGGXX
XXGGPPGGHI10HI10HIGG10XX
XXGGGGGGHIGGHIGGHIGGGGXX
XXGGGGGGHIGGHIGGHI03GGXX
XXGGGGGGHIGGHIGGHIGGGGXX
XXGGGGGGHIGGHIGGHIGG02XX
XXHIHIGGHIGGHIGGHIGGGGXX
XXGGGGGGHIGGGG02GGGG01XX
XXGGHIGGHIGGHIGGHIHIHIXX
XXHHGGGGHIGGHIGGGGGGHHXX
XXXXXXXXXXXXXXXXXXXXXXXX