03
XXXXXXXXXXXXXXXXXXXXXXXX
XXGG0102GGGGGGGGGGGGGGXX
XXGGPPGGXXXXXXXXXXXXXXXX
XXGGGGGGGGGGGGGGGGGGGGXX
XXGGGGGGXXXXXXGGGGGGGGXX
XXGGGGGGWWWWXXXXGGGGGGXX
XXGGGGWWWWWWWWXXGGGGGGXX
XXGGGGGGWWWWXXGGGGHHGGXX
XXGGGGGGGGGGXXIIIIIIIIXX
XXGGGGGGGGGGGGGGGGDDDDXX
XXGGGGGGGGGGGGGGDDDDDDXX
XXXXXXXXXXXXXXXXXXXXXXXX
